################
#      #       #
#  #   #   #   #
#  #   #   #   #
#  #   #   #   #
#  #   #   #    
#  #       #   #
################
